[game]
mapversion=1
metatopic="Map loaded: Archi(maxplayer 2, topology 0) by Kasei"
metamessage="Map loaded: Archi(maxplayer 2, topology 0) by Kasei"
max_players=2
comment="A nice duelmap by Kasei"

[savefile]
options=""

[map]
width=54
height=40
seed=1931033920
topology_id=0
startpos=5
r0sx=47
r0sy=27
r0snation="NO_NATION_SELECTED"
r1sx=6
r1sy=12
r1snation="NO_NATION_SELECTED"
t000="aa                                                  aa"
t001="a                                                    a"
t002="                                                      "
t003="                                                      "
t004="    h                  j                gs            "
t005="     js        g                       sj             "
t006="               hg                                     "
t007="            gpffm                                     "
t008="              sshfg                             jg    "
t009="      g          g                 g             j    "
t010="      fgs        s                 h                  "
t011="      hf                                              "
t012="     pph                                              "
t013="       pfs   g   h     j                   j          "
t014="       gmhgsgggjgg                                    "
t015="        gfhmmfjjhggp                                  "
t016="          ppffhhf                                     "
t017="           gpg  g                                     "
t018="    h                                                 "
t019="                                 j                    "
t020="                    j                                 "
t021="                                                 h    "
t022="                                     g  gpg           "
t023="                                     fhhffpp          "
t024="                                  pgghjjfmmhfg        "
t025="                                    ggjgggsghmg       "
t026="          j                   j     h   g   sfp       "
t027="                                              gpp     "
t028="                                              fg      "
t029="                  h                 s        sgf      "
t030="    j             g                 g          g      "
t031="    gj                             gfhss              "
t032="                                     mffpg            "
t033="                                     gh               "
t034="             js                       g        sj     "
t035="            sg                j                  h    "
t036="                                                      "
t037="                                                      "
t038="a                                                    a"
t039="aa                                                  aa"
l000="000000000000000000000000000000000000000000000000000000"
l001="000000000000000000000000000000000000000000000000000000"
l002="000000000000000000000000000000000000000000000000000000"
l003="000000000000000000000000000000000000000000000000000000"
l004="000010000000000000000000000000000000000100000000000000"
l005="000000000000000000000000000000000000000001000000000000"
l006="000010000000100001000000000000000000000100000000000000"
l007="000000000000000000000000000000000000000000000001000000"
l008="000000000000101000000000000000000000000000000000000000"
l009="000000000000000000000000000000000000000000000000100000"
l010="000000000000000000000000000000000000000000000000000000"
l011="000000000000000000000000000000000000100000000000000000"
l012="000001000000001000000000000000000000000000001000000000"
l013="000000000010100000000000100000000000000000000000000000"
l014="000000100100000000000000000000000000000000000000000000"
l015="000000000000000010000000000000000000000000000000000000"
l016="000000000010100001000000000000000000000000000000000000"
l017="000000000000000000000000000000000000000000000000000000"
l018="000000000001000000000000000000001000000000000000000000"
l019="000001000000000000000000000000000000000000000000000000"
l020="000000000000000000000000000000000000000000000000100000"
l021="000000000000000000000100000000000000000000100000000000"
l022="000000000000000000000000000000000000000000000000000000"
l023="000000000000000000000000000000000000100001010000000000"
l024="000000000000000000000000000000000000010000000000000000"
l025="000000000000000000000000000000000000000000001001000000"
l026="000000000000000000000000000001000000000001010000000000"
l027="000000000100000000000000000000000000000100000000100000"
l028="000000000000000001000000000000000000000000000000000000"
l029="000000000000000000000000000000000000000000000000000000"
l030="000001000000000000000000000000000000000000000000000000"
l031="000000000000000000000000000000000000001010000000000000"
l032="000000100000000000000000000000000000000000000000000000"
l033="000000000000001000000000000000000000100001000000010000"
l034="000000000000100000000000000000000000000000000000000000"
l035="000000000000001000000000000000000000000000000000010000"
l036="000000000000000000000000000000000000000000000000000000"
l037="000000000000000000000000000000000000000000000000000000"
l038="000000000000000000000000000000000000000000000000000000"
l039="000000000000000000000000000000000000000000000000000000"
u000="000000000000000000000000000000000000000000000000000000"
u001="000000000000000000000000000000000000000000000000000000"
u002="000000000000000000000000000000000000000000000000000000"
u003="000000000000000000000000000000000000000000000000000000"
u004="000000000000000000000000000000000000000000000000000000"
u005="000000000000000000000000000000000000000000000000000000"
u006="000000000000000000000000000000000000000000000000000000"
u007="000000000000000000000000000000000000000000000000000000"
u008="000000000000000000000000000000000000000000000000000000"
u009="000000000000000000000000000000000000000000000000000000"
u010="000000000000000000000000000000000000000000000000000000"
u011="000000000000000000000000000000000000000000000000000000"
u012="000000000000000000000000000000000000000000000000000000"
u013="000000000000000000000000000000000000000000000000000000"
u014="000000000000000000000000000000000000000000000000000000"
u015="000000000000000000000000000000000000000000000000000000"
u016="000000000000000000000000000000000000000000000000000000"
u017="000000000000000000000000000000000000000000000000000000"
u018="000000000000000000000000000000000000000000000000000000"
u019="000000000000000000000000000000000000000000000000000000"
u020="000000000000000000000000000000000000000000000000000000"
u021="000000000000000000000000000000000000000000000000000000"
u022="000000000000000000000000000000000000000000000000000000"
u023="000000000000000000000000000000000000000000000000000000"
u024="000000000000000000000000000000000000000000000000000000"
u025="000000000000000000000000000000000000000000000000000000"
u026="000000000000000000000000000000000000000000000000000000"
u027="000000000000000000000000000000000000000000000000000000"
u028="000000000000000000000000000000000000000000000000000000"
u029="000000000000000000000000000000000000000000000000000000"
u030="000000000000000000000000000000000000000000000000000000"
u031="000000000000000000000000000000000000000000000000000000"
u032="000000000000000000000000000000000000000000000000000000"
u033="000000000000000000000000000000000000000000000000000000"
u034="000000000000000000000000000000000000000000000000000000"
u035="000000000000000000000000000000000000000000000000000000"
u036="000000000000000000000000000000000000000000000000000000"
u037="000000000000000000000000000000000000000000000000000000"
u038="000000000000000000000000000000000000000000000000000000"
u039="000000000000000000000000000000000000000000000000000000"
n000="000000000000000000000000000000000000000000000000000000"
n001="000000000000000000000000000000000000000000000000000000"
n002="000000000000000000000000000000000000000000000000000000"
n003="000000000000000000000000000000000000000000000000000000"
n004="000000000000000000000000000000000000000000000000000000"
n005="000000100000001000000010000000000000000000000000000000"
n006="000000000000000000000000000000000000000000000000000000"
n007="000000000000000000000000000000000000000000000000000000"
n008="000000010000000000000000000000000000000000000000000000"
n009="000000000000000000100000000000000001000000000000000000"
n010="000001001000000000000000000000000000000000000000000000"
n011="000000000000000001000000000000000000000000000000000000"
n012="000000001000000000000000000000000000000000000000000000"
n013="000000000000000000100001000000000000000000000000000000"
n014="000000000000000000000000000000000000000000000000000000"
n015="000000010000001000010000000000000000000000000000000000"
n016="000000000000000000000000000000000000000000000000000000"
n017="000000000000001000000000000000000000000000000000000000"
n018="000010000000000000000000000000000000000000000000000000"
n019="000000000000000000000000000000000100000000000000000000"
n020="000000000000000000001000000000000000000000000000000000"
n021="000000000000000000000000000000000000000000000000010000"
n022="000000000000000000000000000000000000000100000000000000"
n023="000000000000000000000000000000000000000000000000000000"
n024="000000000000000000000000000000000010000100000010000000"
n025="000000000000000000000000000000000000000000000000000000"
n026="000000000000000000000000000000100001000000000000000000"
n027="000000000000000000000000000000000000000000000100000000"
n028="000000000000000000000000000000000000100000000000000000"
n029="000000000000000000000000000000000000000000000100100000"
n030="000000000000000000100000000000000001000000000000000000"
n031="000000000000000000000000000000000000000000000010000000"
n032="000000000000000000000000000000000000000000000000000000"
n033="000000000000000000000000000000000000000000000000000000"
n034="000000000000000000000000000000010000000100000001000000"
n035="000000000000000000000000000000000000000000000000000000"
n036="000000000000000000000000000000000000000000000000000000"
n037="000000000000000000000000000000000000000000000000000000"
n038="000000000000000000000000000000000000000000000000000000"
n039="000000000000000000000000000000000000000000000000000000"
f000="000000000000000000000000000000000000000000000000000000"
f001="000000000000000000000000000000000000000000000000000000"
f002="000000000000000000000000000000000000000000000000000000"
f003="000000000000000000000000000000000000000000000000000000"
f004="000000000000000000000000000000000000000000000000000000"
f005="000000000000000000000000000000000000000000000000000000"
f006="000000000000000000000000000000000000000000000000000000"
f007="000000000000000000000000000000000000000000000000000000"
f008="000000000000000000000000000000000000000000000000000000"
f009="000000000000000000000000000000000000000000000000000000"
f010="000000000000000000000000000000000000000000000000000000"
f011="000000000000000000000000000000000000000000000000000000"
f012="000000000000000000000000000000000000000000000000000000"
f013="000000000000000000000000000000000000000000000000000000"
f014="000000000000000000000000000000000000000000000000000000"
f015="000000000000000000000000000000000000000000000000000000"
f016="000000000000000000000000000000000000000000000000000000"
f017="000000000000000000000000000000000000000000000000000000"
f018="000000000000000000000000000000000000000000000000000000"
f019="000000000000000000000000000000000000000000000000000000"
f020="000000000000000000000000000000000000000000000000000000"
f021="000000000000000000000000000000000000000000000000000000"
f022="000000000000000000000000000000000000000000000000000000"
f023="000000000000000000000000000000000000000000000000000000"
f024="000000000000000000000000000000000000000000000000000000"
f025="000000000000000000000000000000000000000000000000000000"
f026="000000000000000000000000000000000000000000000000000000"
f027="000000000000000000000000000000000000000000000000000000"
f028="000000000000000000000000000000000000000000000000000000"
f029="000000000000000000000000000000000000000000000000000000"
f030="000000000000000000000000000000000000000000000000000000"
f031="000000000000000000000000000000000000000000000000000000"
f032="000000000000000000000000000000000000000000000000000000"
f033="000000000000000000000000000000000000000000000000000000"
f034="000000000000000000000000000000000000000000000000000000"
f035="000000000000000000000000000000000000000000000000000000"
f036="000000000000000000000000000000000000000000000000000000"
f037="000000000000000000000000000000000000000000000000000000"
f038="000000000000000000000000000000000000000000000000000000"
f039="000000000000000000000000000000000000000000000000000000"
