[game]
mapversion=1
metatopic="Map loaded: Two arctic ways(maxplayer 2, topology 1) by Kasei"
metamessage="Map loaded: Two arctic ways(maxplayer 2, topology 1) by Kasei"
max_players=2
comment="A duel map with 2 seaways in between both lands"

[savefile]
options=""

[map]
width=20
height=38
seed=1381023420
topology_id=1
startpos=5
r0sx=9
r0sy=5
r0snation="NO_NATION_SELECTED"
r1sx=10
r1sy=32
r1snation="NO_NATION_SELECTED"
t000="                    "
t001="                    "
t002="  ggss   jg         "
t003="gssppggphfggp       "
t004="pg mmhgghffssgj    p"
t005="ghmmhffgpfmmppfjg gg"
t006="gggpppspfpgmfgggpfgp"
t007="ppgfg  p ppggpphfggp"
t008="   gh    ghfp   hpfg"
t009="         gpf     pp "
t010="         p          "
t011="                    "
t012="     m              "
t013="t                  t"
t014="at                tt"
t015="aa         ff     ta"
t016="aat      ttpf     aa"
t017="aaaa     aatp    aaa"
t018="maaa     aaa     aaa"
t019="aaa     aaa     aaam"
t020="aaa    ptaa     aaaa"
t021="aa     fptt      taa"
t022="at     ff         aa"
t023="tt                ta"
t024="t                  t"
t025="              g     "
t026="                    "
t027="          p         "
t028=" pp     fpg         "
t029="gfph   pfhg    hg   "
t030="pggfhppffpp p  gfgpp"
t031="pgfpgggfmgpfpspppggg"
t032="gg gjfppmmfpgffhmmhg"
t033="p    jgssffhgghmm gp"
t034="       pggfhpggppssg"
t035="         gj   ssgg  "
t036="                    "
t037="                    "
l000="00000000000000000000"
l001="00000010000000000000"
l002="01000000000000000000"
l003="00000100000001000000"
l004="00100000000000000000"
l005="00001000000000100001"
l006="00000000000000000000"
l007="00000000000000000001"
l008="00000000000000000000"
l009="00000100000001000000"
l010="00000000100000000100"
l011="00000000000000000000"
l012="00001000000000000000"
l013="00000000000000000000"
l014="00000000000000000000"
l015="00100000000010000000"
l016="00000000000000000000"
l017="00000000001001000000"
l018="10100000000000000000"
l019="00000000000000000101"
l020="00000010010000000000"
l021="00000000000000000000"
l022="00000001000000000000"
l023="00000000000000000000"
l024="00000000000000000000"
l025="00000000000000010000"
l026="00000000000000000000"
l027="00100000000100000000"
l028="00000010000000100000"
l029="00000000000000000000"
l030="10000000000000000000"
l031="00000000000000000000"
l032="10000100000000010000"
l033="00000000000000000100"
l034="00000010000000100000"
l035="00000000000000000010"
l036="00000000000001000000"
l037="00000000000000000000"
u000="00000000000000000000"
u001="00000000000000000000"
u002="00000000000000000000"
u003="00000000000000000000"
u004="00000000000000000000"
u005="00000000000000000000"
u006="00000000000000000000"
u007="00000000000000000000"
u008="00000000000000000000"
u009="00000000000000000000"
u010="00000000000000000000"
u011="00000000000000000000"
u012="00000000000000000000"
u013="00000000000000000000"
u014="00000000000000000000"
u015="00000000000000000000"
u016="00000000000000000000"
u017="00000000000000000000"
u018="00000000000000000000"
u019="00000000000000000000"
u020="00000000000000000000"
u021="00000000000000000000"
u022="00000000000000000000"
u023="00000000000000000000"
u024="00000000000000000000"
u025="00000000000000000000"
u026="00000000000000000000"
u027="00000000000000000000"
u028="00000000000000000000"
u029="00000000000000000000"
u030="00000000000000000000"
u031="00000000000000000000"
u032="00000000000000000000"
u033="00000000000000000000"
u034="00000000000000000000"
u035="00000000000000000000"
u036="00000000000000000000"
u037="00000000000000000000"
n000="00000000000000000000"
n001="00010000000000000000"
n002="00000000120100000000"
n003="02200000020000000001"
n004="00000000120100001000"
n005="00002230022000000000"
n006="00000020000100200100"
n007="01000010000000200000"
n008="00000000001000010000"
n009="00010000000000000001"
n010="00000000000000000000"
n011="00000000001000000000"
n012="00000000000000000000"
n013="00000010000000000010"
n014="00000000000000000000"
n015="00000000001000000000"
n016="10000000000000000000"
n017="00000000000000000000"
n018="00000000000000000000"
n019="00000000000000000000"
n020="00000000000000000000"
n021="00000000000000000001"
n022="00000000010000000000"
n023="00000000000000000000"
n024="01000000000000000000"
n025="00000000000000000000"
n026="00000000010000000000"
n027="00000000000000000000"
n028="10000000000000001000"
n029="00001000010000000000"
n030="00000200000101000010"
n031="00100200100002000000"
n032="00000000022003220000"
n033="00010000102100000000"
n034="10000000002000000220"
n035="00000000102100000000"
n036="00000000000000001000"
n037="00000000000000000000"
f000="00000000000000000000"
f001="00000000000000000000"
f002="00000000000000000000"
f003="00000000000000000000"
f004="00000000000000000000"
f005="00000000000000000000"
f006="00000000000000000000"
f007="00000000000000000000"
f008="00000000000000000000"
f009="00000000000000000000"
f010="00000000000000000000"
f011="00000000000000000000"
f012="00000000000000000000"
f013="00000000000000000000"
f014="00000000000000000000"
f015="00000000000000000000"
f016="00000000000000000000"
f017="00000000000000000000"
f018="00000000000000000000"
f019="00000000000000000000"
f020="00000000000000000000"
f021="00000000000000000000"
f022="00000000000000000000"
f023="00000000000000000000"
f024="00000000000000000000"
f025="00000000000000000000"
f026="00000000000000000000"
f027="00000000000000000000"
f028="00000000000000000000"
f029="00000000000000000000"
f030="00000000000000000000"
f031="00000000000000000000"
f032="00000000000000000000"
f033="00000000000000000000"
f034="00000000000000000000"
f035="00000000000000000000"
f036="00000000000000000000"
f037="00000000000000000000"

