[game]
mapversion=1
metatopic="Map loaded: Islands(maxplayer 8, topology 3) by Kasei"
metamessage="Map loaded: Islands(maxplayer 8, topology 3) by Kasei"
max_players=8
comment="A 8 player map with small islands in 4 groups of 2 islands created by Kasei"

[savefile]
options=""

[map]
width=65
height=46
seed=1931033920
topology_id=3
startpos=5
r0sx=9
r0sy=10
r0snation="NO_NATION_SELECTED"
r1sx=9
r1sy=33
r1snation="NO_NATION_SELECTED"
r2sx=22
r2sy=13
r2snation="NO_NATION_SELECTED"
r3sx=22
r3sy=36
r3snation="NO_NATION_SELECTED"
r4sx=42
r4sy=13
r4snation="NO_NATION_SELECTED"
r5sx=42
r5sy=36 
r5snation="NO_NATION_SELECTED"
r6sx=55
r6sy=10
r6snation="NO_NATION_SELECTED"
r7sx=55
r7sy=33
r7snation="NO_NATION_SELECTED"
t000="                                                                 "
t001="                                                                 "
t002="                                                                 "
t003="                                                                 "
t004="                                                                 "
t005="                h                               h                "
t006="        g   g                                       g   g        "
t007="     gpggppfg         pp   g         g   pp         gfppggpg     "
t008="     gphf pgfg      f j    h         h    j f      gfgp fhpg     "
t009="      pghmmgf       psj                   jsp       fgmmhgp      "
t010="      fgffmgp       ggp                   pgg       pgmffgf      "
t011="      fssgfhpf    gpphg g               g ghppg    fphfgssf      "
t012="       g ghppg    fphfgssf             fssgfhpf    gpphg g       "
t013="         pgg       pgmffgf             fgffmgp       ggp         "
t014="         jsp       fgmmhgp             pghmmgf       psj         "
t015="    h    j f      gfgp fhpg           gphf pgfg      f j    h    "
t016="    g   pp         gfppggpg           gpggppfg         pp   g    "
t017="                   g   g                 g   g                   "
t018="               h                                 h               "
t019="                                                                 "
t020="                                                                 "
t021="                                                                 "
t022="                                                                 "
t023="                                                                 "
t024="                                                                 "
t025="                                                                 "
t026="                                                                 "
t027="                                                                 "
t028="                h                               h                "
t029="        g   g                                       g   g        "
t030="     gpggppfg         pp   g         g   pp         gfppggpg     "
t031="     gphf pgfg      f j    h         h    j f      gfgp fhpg     "
t032="      pghmmgf       psj                   jsp       fgmmhgp      "
t033="      fgffmgp       ggp                   pgg       pgmffgf      "
t034="      fssgfhpf    gpphg g               g ghppg    fphfgssf      "
t035="       g ghppg    fphfgssf             fssgfhpf    gpphg g       "
t036="         pgg       pgmffgf             fgffmgp       ggp         "
t037="         jsp       fgmmhgp             pghmmgf       psj         "
t038="    h    j f      gfgp fhpg           gphf pgfg      f j    h    "
t039="    g   pp         gfppggpg           gpggppfg         pp   g    "
t040="                   g   g                 g   g                   "
t041="               h                                 h               "
t042="                                                                 "
t043="                                                                 "
t044="                                                                 "
t045="                                                                 "
l000="00000000000000000000000000000000000000000000000000000000000000000"
l001="00000000000000000000000000000000000000000000000000000000000000000"
l002="00000000000000000000000000000000000000000000000000000000000000000"
l003="00000000000000000000000000000000000000000000000000000000000000000"
l004="00000000000000000000000000000000000000000000000000000000000000000"
l005="00000000000100000000000000000000000000000000000000000100000000000"
l006="00000000010000000100000000000000000000000000000100000001000000000"
l007="00001000000100000001000100000000000000000100010000000000000010000"
l008="00000001010200000000000000010000000001000000000000000201010000000"
l009="00000002202000000000000000000000000000000000000000000020220000000"
l010="00000000021001000001000000100000000000100000010000010012000000000"
l011="00000000020100000000000000000000000000000000000000000102000000000"
l012="00000000000000000000102000000000000000000020100000000000000000000"
l013="00000100000010000010012000000000000000000021001000001000000100000"
l014="00000000000000000000020220000000000000002202000000000000000000000"
l015="00001000000000000000201010000000000000001010200000000000000010000"
l016="00000000100010000000100000010000000001000000100000001000100000000"
l017="00000000000000100000001000000000000000000010000000100000000000000"
l018="00000000000000000000100000000000000000000000100000000000000000000"
l019="00000000000000000000000000000000000000000000000000000000000000000"
l020="00000000000000000000000000000000000000000000000000000000000000000"
l021="00000000000000000000000000000000000000000000000000000000000000000"
l022="00000000000000000000000000000000000000000000000000000000000000000"
l023="00000000000000000000000000000000000000000000000000000000000000000"
l024="00000000000000000000000000000000000000000000000000000000000000000"
l025="00000000000000000000000000000000000000000000000000000000000000000"
l026="00000000000000000000000000000000000000000000000000000000000000000"
l027="00000000000000000000000000000000000000000000000000000000000000000"
l028="00000000000100000000000000000000000000000000000000000100000000000"
l029="00000000010000000100000000000000000000000000000100000001000000000"
l030="00001000000100000001000100000000000000000100010000000000000010000"
l031="00000001010200000000000000010000000001000000000000000201010000000"
l032="00000002202000000000000000000000000000000000000000000020220000000"
l033="00000000021001000001000000100000000000100000010000010012000000000"
l034="00000000020100000000000000000000000000000000000000000102000000000"
l035="00000000000000000000102000000000000000000020100000000000000000000"
l036="00000100000010000010012000000000000000000021001000001000000100000"
l037="00000000000000000000020220000000000000002202000000000000000000000"
l038="00001000000000000000201010000000000000001010200000000000000010000"
l039="00000000100010000000100000010000000001000000100000001000100000000"
l040="00000000000000100000001000000000000000000010000000100000000000000"
l041="00000000000000000000100000000000000000000000100000000000000000000"
l042="00000000000000000000000000000000000000000000000000000000000000000"
l043="00000000000000000000000000000000000000000000000000000000000000000"
l044="00000000000000000000000000000000000000000000000000000000000000000"
l045="00000000000000000000000000000000000000000000000000000000000000000"
u000="00000000000000000000000000000000000000000000000000000000000000000"
u001="00000000000000000000000000000000000000000000000000000000000000000"
u002="00000000000000000000000000000000000000000000000000000000000000000"
u003="00000000000000000000000000000000000000000000000000000000000000000"
u004="00000000000000000000000000000000000000000000000000000000000000000"
u005="00000000000000000000000000000000000000000000000000000000000000000"
u006="00000000000000000000000000000000000000000000000000000000000000000"
u007="00000000000000000000000000000000000000000000000000000000000000000"
u008="00000000000000000000000000000000000000000000000000000000000000000"
u009="00000000000000000000000000000000000000000000000000000000000000000"
u010="00000000000000000000000000000000000000000000000000000000000000000"
u011="00000000000000000000000000000000000000000000000000000000000000000"
u012="00000000000000000000000000000000000000000000000000000000000000000"
u013="00000000000000000000000000000000000000000000000000000000000000000"
u014="00000000000000000000000000000000000000000000000000000000000000000"
u015="00000000000000000000000000000000000000000000000000000000000000000"
u016="00000000000000000000000000000000000000000000000000000000000000000"
u017="00000000000000000000000000000000000000000000000000000000000000000"
u018="00000000000000000000000000000000000000000000000000000000000000000"
u019="00000000000000000000000000000000000000000000000000000000000000000"
u020="00000000000000000000000000000000000000000000000000000000000000000"
u021="00000000000000000000000000000000000000000000000000000000000000000"
u022="00000000000000000000000000000000000000000000000000000000000000000"
u023="00000000000000000000000000000000000000000000000000000000000000000"
u024="00000000000000000000000000000000000000000000000000000000000000000"
u025="00000000000000000000000000000000000000000000000000000000000000000"
u026="00000000000000000000000000000000000000000000000000000000000000000"
u027="00000000000000000000000000000000000000000000000000000000000000000"
u028="00000000000000000000000000000000000000000000000000000000000000000"
u029="00000000000000000000000000000000000000000000000000000000000000000"
u030="00000000000000000000000000000000000000000000000000000000000000000"
u031="00000000000000000000000000000000000000000000000000000000000000000"
u032="00000000000000000000000000000000000000000000000000000000000000000"
u033="00000000000000000000000000000000000000000000000000000000000000000"
u034="00000000000000000000000000000000000000000000000000000000000000000"
u035="00000000000000000000000000000000000000000000000000000000000000000"
u036="00000000000000000000000000000000000000000000000000000000000000000"
u037="00000000000000000000000000000000000000000000000000000000000000000"
u038="00000000000000000000000000000000000000000000000000000000000000000"
u039="00000000000000000000000000000000000000000000000000000000000000000"
u040="00000000000000000000000000000000000000000000000000000000000000000"
u041="00000000000000000000000000000000000000000000000000000000000000000"
u042="00000000000000000000000000000000000000000000000000000000000000000"
u043="00000000000000000000000000000000000000000000000000000000000000000"
u044="00000000000000000000000000000000000000000000000000000000000000000"
u045="00000000000000000000000000000000000000000000000000000000000000000"
n000="00000000000000000000000000000000000000000000000000000000000000000"
n001="00000000000000000000000000000000000000000000000000000000000000000"
n002="00000000000000000000000000000000000000000000000000000000000000000"
n003="00000000000000000000000000000000000000000000000000000000000000000"
n004="00000000000000001000000000000000000000000000000010000000000000000"
n005="00000000000000001000000000000000000000000000000010000000000000000"
n006="00000001000000000000000000100000000000100000000000000000010000000"
n007="00000000000001000000000000000000000000000000000000010000000000000"
n008="00000002200000000000010000000000000000000001000000000000220000000"
n009="00000100000000000000000000000000000000000000000000000000000100000"
n010="00000001232000000000000100000000000000000100000000000023210000000"
n011="00000002200000000000000100000000000000000100000000000000220000000"
n012="00000000100000000000000220000000000000002200000000000000100000000"
n013="00000000100000000000023210000000000000001232000000000000100000000"
n014="00000000000000000000000000100000000000100000000000000000000000000"
n015="00000000001000000000000220000000000000002200000000000010000000000"
n016="00000000000000000010000000000000000000000000001000000000000000000"
n017="00000100000000000000000010000000000000001000000000000000000100000"
n018="00000000000000010000000000000000000000000000000001000000000000000"
n019="00000000000000010000000000000000000000000000000001000000000000000"
n020="00000000000000000000000000000000000000000000000000000000000000000"
n021="00000000000000000000000000000000000000000000000000000000000000000"
n022="00000000000000000000000000000000000000000000000000000000000000000"
n023="00000000000000000000000000000000000000000000000000000000000000000"
n024="00000000000000000000000000000000000000000000000000000000000000000"
n025="00000000000000000000000000000000000000000000000000000000000000000"
n026="00000000000000000000000000000000000000000000000000000000000000000"
n027="00000000000000001000000000000000000000000000000010000000000000000"
n028="00000000000000001000000000000000000000000000000010000000000000000"
n029="00000001000000000000000000100000000000100000000000000000010000000"
n030="00000000000001000000000000000000000000000000000000010000000000000"
n031="00000002200000000000010000000000000000000001000000000000220000000"
n032="00000100000000000000000000000000000000000000000000000000000100000"
n033="00000001232000000000000100000000000000000100000000000023210000000"
n034="00000002200000000000000100000000000000000100000000000000220000000"
n035="00000000100000000000000220000000000000002200000000000000100000000"
n036="00000000100000000000023210000000000000001232000000000000100000000"
n037="00000000000000000000000000100000000000100000000000000000000000000"
n038="00000000001000000000000220000000000000002200000000000010000000000"
n039="00000000000000000010000000000000000000000000001000000000000000000"
n040="00000100000000000000000010000000000000001000000000000000000100000"
n041="00000000000000010000000000000000000000000000000001000000000000000"
n042="00000000000000010000000000000000000000000000000001000000000000000"
n043="00000000000000000000000000000000000000000000000000000000000000000"
n044="00000000000000000000000000000000000000000000000000000000000000000"
n045="00000000000000000000000000000000000000000000000000000000000000000"
f000="00000000000000000000000000000000000000000000000000000000000000000"
f001="00000000000000000000000000000000000000000000000000000000000000000"
f002="00000000000000000000000000000000000000000000000000000000000000000"
f003="00000000000000000000000000000000000000000000000000000000000000000"
f004="00000000000000000000000000000000000000000000000000000000000000000"
f005="00000000000000000000000000000000000000000000000000000000000000000"
f006="00000000000000000000000000000000000000000000000000000000000000000"
f007="00000000000000000000000000000000000000000000000000000000000000000"
f008="00000000000000000000000000000000000000000000000000000000000000000"
f009="00000000000000000000000000000000000000000000000000000000000000000"
f010="00000000000000000000000000000000000000000000000000000000000000000"
f011="00000000000000000000000000000000000000000000000000000000000000000"
f012="00000000000000000000000000000000000000000000000000000000000000000"
f013="00000000000000000000000000000000000000000000000000000000000000000"
f014="00000000000000000000000000000000000000000000000000000000000000000"
f015="00000000000000000000000000000000000000000000000000000000000000000"
f016="00000000000000000000000000000000000000000000000000000000000000000"
f017="00000000000000000000000000000000000000000000000000000000000000000"
f018="00000000000000000000000000000000000000000000000000000000000000000"
f019="00000000000000000000000000000000000000000000000000000000000000000"
f020="00000000000000000000000000000000000000000000000000000000000000000"
f021="00000000000000000000000000000000000000000000000000000000000000000"
f022="00000000000000000000000000000000000000000000000000000000000000000"
f023="00000000000000000000000000000000000000000000000000000000000000000"
f024="00000000000000000000000000000000000000000000000000000000000000000"
f025="00000000000000000000000000000000000000000000000000000000000000000"
f026="00000000000000000000000000000000000000000000000000000000000000000"
f027="00000000000000000000000000000000000000000000000000000000000000000"
f028="00000000000000000000000000000000000000000000000000000000000000000"
f029="00000000000000000000000000000000000000000000000000000000000000000"
f030="00000000000000000000000000000000000000000000000000000000000000000"
f031="00000000000000000000000000000000000000000000000000000000000000000"
f032="00000000000000000000000000000000000000000000000000000000000000000"
f033="00000000000000000000000000000000000000000000000000000000000000000"
f034="00000000000000000000000000000000000000000000000000000000000000000"
f035="00000000000000000000000000000000000000000000000000000000000000000"
f036="00000000000000000000000000000000000000000000000000000000000000000"
f037="00000000000000000000000000000000000000000000000000000000000000000"
f038="00000000000000000000000000000000000000000000000000000000000000000"
f039="00000000000000000000000000000000000000000000000000000000000000000"
f040="00000000000000000000000000000000000000000000000000000000000000000"
f041="00000000000000000000000000000000000000000000000000000000000000000"
f042="00000000000000000000000000000000000000000000000000000000000000000"
f043="00000000000000000000000000000000000000000000000000000000000000000"
f044="00000000000000000000000000000000000000000000000000000000000000000"
f045="00000000000000000000000000000000000000000000000000000000000000000"
